WWWWWWWWWW
W---S----W
W-P---S--W
W--------W
W--S-----W
W----S---W
W--------W
WS----S--W
W--S-----W
WWWWWWWWWW